111111111111
100000111001
100000111001
100000111001
100000000001
111111111111
